Data	Chaine
<data=activité>	<attribut=coût_produit_final><attribut=coût_de_produit_intermédiaire><attribut=coût_client><attribut=volume>
<data=article>	<attribut=tarif><attribut=volume>
<data=catégorie>	<attribut=version><attribut=libellé_catégorie><attribut=client><attribut=libellé_client><attribut=montant_>
<data=client>	<attribut=version><attribut=catégorie><attribut=libellé_catégorie><attribut=libellé_client><attribut=montant_><attribut=chiffre_d_Affaire><attribut=coût><attribut=prix><attribut=facturé><attribut=montant_à_facturer><attribut=taux_de_majoration><attribut=prix_de_prestation><attribut=coût_de_prestation><attribut=volume_d_article>
<data=coût_des_activités>	<attribut=ECAMO><attribut=coût_de_support_et_d_appui>
<data=étape>	<attribut=role_vision><attribut=périmètre_d_accès_à_la_structure><attribut=périmètre_d_accès_au_produit_intermédiaire><attribut=périmètre_d_accès_au_produit_final><attribut=périmètre_d_accès_au_client>
<data=exemption>	<attribut=année><attribut=nature>
<data=libellé_catégorie>	<attribut=version><attribut=catégorie><attribut=client><attribut=libellé_client><attribut=montant_>
<data=libellé_client>	<attribut=version><attribut=catégorie><attribut=libellé_catégorie><attribut=client><attribut=montant_>
<data=MOA>	<attribut=prestation><attribut=produit_intermédiaire><attribut=payeur__><attribut=coût_de_produit_final>
<data=mois_/_année>	<attribut=prestation><attribut=produit_intermédiaire><attribut=version><attribut=volume><attribut=Unité_de_volume__>
<data=montant_>	<attribut=version><attribut=catégorie><attribut=libellé_catégorie><attribut=client><attribut=libellé_client>
<data=nature_de_charge>	<attribut=coût_produit_final><attribut=coût_de_produit_intermédiaire><attribut=prix_de_prestation><attribut=coût_client><attribut=coût_de_prestation><attribut=coût_des_activités>
<data=New_AEPR/PGI>	<attribut=article><attribut=activité_DSP><attribut=catégorie_pilotis><attribut=structure><attribut=centre_de_coût><attribut=centre_de_profit><attribut=client><attribut=clé_de_groupe><attribut=commande_d_achat><attribut=demande_d_achat><attribut=eOTP><attribut=OI_(Ordre_Interne)><attribut=filière_IT><attribut=fournisseur><attribut=montant_engagé><attribut=montant_réalisé><attribut=numéro_de_besoin><attribut=numéro_de_contrat><attribut=nature_comptable_de_charge><attribut=exercice_comptable><attribut=période_comptable><attribut=période><attribut=poste_de_commande><attribut=chargement_déchargement><attribut=type_de_valeur>
<data=objet_de_gestion>	<attribut=rabot><attribut=marge><attribut=aléa>
<data=payeur__>	<attribut=prestation><attribut=produit_intermédiaire><attribut=MOA>
<data=périmètre_d_accès_à_la_structure>	<attribut=role_vision><attribut=périmètre_d_accès_au_produit_intermédiaire><attribut=périmètre_d_accès_au_produit_final><attribut=périmètre_d_accès_au_client><attribut=étape>
<data=périmètre_d_accès_au_client>	<attribut=role_vision><attribut=périmètre_d_accès_à_la_structure><attribut=périmètre_d_accès_au_produit_intermédiaire><attribut=périmètre_d_accès_au_produit_final><attribut=étape>
<data=périmètre_d_accès_au_produit_final>	<attribut=role_vision><attribut=périmètre_d_accès_à_la_structure><attribut=périmètre_d_accès_au_produit_intermédiaire><attribut=périmètre_d_accès_au_client><attribut=étape>
<data=périmètre_d_accès_au_produit_intermédiaire>	<attribut=role_vision><attribut=périmètre_d_accès_à_la_structure><attribut=périmètre_d_accès_au_produit_final><attribut=périmètre_d_accès_au_client><attribut=étape>
<data=prestation>	<attribut=montant_à_facturer><attribut=produit_intermédiaire><attribut=MOA><attribut=payeur__><attribut=mois_/_année><attribut=version><attribut=volume><attribut=Unité_de_volume__><attribut=coût><attribut=prix><attribut=coût_client><attribut=coût_unitaire><attribut=volume_de_produit_intermédiaire><attribut=client>
<data=prévisionnel>	<attribut=taux_de_taxe_sur_salaire_>
<data=prix_de_prestation>	<attribut=client><attribut=produit_intermédiaire><attribut=activité>
<data=produit_final>	<attribut=taux_de_majoration><attribut=volume><attribut=volume_de_produit_intermédiaire>
<data=produit_intermédiaire>	<attribut=coût_produit_final><attribut=prestation><attribut=MOA><attribut=payeur__><attribut=mois_/_année><attribut=version><attribut=volume><attribut=Unité_de_volume__><attribut=coût_client><attribut=coût><attribut=coût_d_activité_consommé><attribut=coût_unitaire>
<data=projet>	<attribut=jalon><attribut=coût><attribut=coût_direct_valeur><attribut=volume><attribut=coût_indirect_volume><attribut=coût_indirect_valeur>
<data=rapport>	<attribut=habilitation>
<data=role_vision>	<attribut=périmètre_d_accès_à_la_structure><attribut=périmètre_d_accès_au_produit_intermédiaire><attribut=périmètre_d_accès_au_produit_final><attribut=périmètre_d_accès_au_client><attribut=étape>
<data=structure>	<attribut=chiffre_d_Affaire><attribut=utilisateur><attribut=coût_des_activités><attribut=coût_de_produit_intermédiaire><attribut=coût_client><attribut=coût><attribut=volume><attribut=coût_unitaire_d_activité>
<data=type_de_client>	<attribut=tarif>
<data=Unité_de_volume__>	<attribut=prestation><attribut=produit_intermédiaire><attribut=mois_/_année><attribut=version><attribut=volume>
<data=version>	<attribut=catégorie><attribut=libellé_catégorie><attribut=client><attribut=libellé_client><attribut=montant_><attribut=prestation><attribut=produit_intermédiaire><attribut=mois_/_année><attribut=volume><attribut=Unité_de_volume__>
<data=version_budgétaire>	<attribut=calendrier_de_gestion><attribut=type_d_exercice><attribut=version_de_référence><attribut=année><attribut=période><attribut=structure_responsable><attribut=indice_de_version><attribut=statut><attribut=date_limite_de_saisie>
<data=volume>	<attribut=prestation><attribut=produit_intermédiaire><attribut=mois_/_année><attribut=version><attribut=Unité_de_volume__>
